X00N00,X00N00,X00N00,X00N00,X00N00,X00N00,X00N00,X00N00,X00N00,X00N00,X00N00,X00N00,X00N00,X00N00,X00N00
X00N00,E00N00,E00N00,E00N00,E00N00,E00N00,E00N00,E00N00,E00N00,E00N00,E00N00,E00N00,E00N00,E00N00,X00N00
X00N00,E00N00,F00N00,F00N00,F00N00,E00N00,E00N00,E00N00,E00N00,E00N00,E00N00,E00N00,E00N00,E00N00,X00N00
X00N00,E00C00,F00N00,F00N00,F00N00,E00N00,E00N00,E00N00,E00N00,E00N00,E00N00,E00N00,E00N00,E00N00,X00N00
X00N00,E00N00,F00N00,F00N00,F00N00,E00N00,E00N00,E00N00,E00N00,E00N00,E00N00,E00N00,E00N00,E00N00,X00N00
X00N00,E00N00,E00N00,E00N00,E00N00,E00N00,E00N00,E00N00,E00N00,E00N00,E00N00,E00N00,E00N00,E00N00,X00N00
X00N00,E00N00,E00N00,E00N00,E00N00,E00N00,E00N00,E00N00,E00N00,E00N00,E00N00,E00N00,E00N00,E00N00,X00N00
X00N00,E00N00,E00N00,E00N00,E00N00,E00N00,E00N00,E00N00,E00N00,E00N00,E00N00,E00N00,E00N00,E00N00,X00N00
X00N00,E00N00,E00N00,E00N00,E00N00,E00N00,E00N00,E00N00,E00N00,E00N00,E00N00,E00N00,E00N00,E00N00,X00N00
X00N00,E00N00,E00N00,E00N00,E00N00,E00N00,E00N00,E00N00,E00N00,E00N00,E00N00,E00N00,E00N00,E00N00,X00N00
X00N00,E00N00,E00N00,E00N00,E00N00,E00N00,E00N00,E00N00,E00N00,E00N00,E00N00,E00N00,E00N00,E00N00,X00N00
X00N00,E00N01,E00N01,E00N01,E00N00,E00N00,E00N00,E00N00,E00N00,E00N00,E00N00,E00N00,E00N00,E00N00,X00N00
X00N00,E00N01,F00N00,E00N01,E00N00,F00N01,E00N00,E00N00,E00N00,E00N00,E00N00,E00N00,E00N00,E00N00,X00N00
X00N00,E00S01,E00N01,E00N01,E00N00,E00N00,E00N00,E00N00,E00N00,E00N00,E00N00,E00N00,E00N00,E00N00,X00N00
X00N00,X00N00,X00N00,X00N00,X00N00,X00N00,X00N00,X00N00,X00N00,X00N00,X00N00,X00N00,X00N00,X00N00,X00N00
